pathway,precursors
map00902,C00341
map00909,C00448
map00904,C00353
map00906,C00353;C00448
map00905,C01789
map00908,C00235
map00940,C00079
map00941,C00079
map00944,C00079
map00942,C00079
map00943,C00079
map00945,C00079
map00965,C00082
map00966,C00073;C00079;C00078;C00082;C00183;C00123;C00407
map00402,C03506
